##########
###...#C##
#...#....#
##.####.##
#..###...#
##..G##.##
##########
